xxxxxxxxxxxxxxxxxxxx
x------------------x
x----------t-------x
x------------------x
x---------bbbbbbbbbx
xB-----------------x
xB-----p----bbbbb--x
xB-----------------x
xB-----xx------g---x
x--b---------------x
x------g-----------x
x------------------x
x-----------BBBBB--x
x-------e----------x
xxxxxxxxxxxxxxxxxxxx