xxxxxxxxxxxxxxxxxxxx
x------x-----------x
x------x-----------x
x--g---xxxxxxxxxxx-x
x------------------x
x------------------x
x--------xxxxxx----x
x--------x---------x
x--BbB---x---------x
x---B----x--g------x
x---b----x---------x
x--------x---------x
x-------tx---------x
x---p-------e----g-x
xxxxxxxxxxxxxxxxxxxx